@@@@@@@@@
@       @
@ @@@@@@@
@   @   @
@ @ @ @ @
@ @   @!@
@ @@@@@@@
@       @
@@@@@O@@@
