@@@@@@@@@@@@@@@@@@@@@@@@@@@@@@@@@@@@@@@@@@@@@@@@@@@@@@@@@@@@@@@@@@@@@@@@@@@@@@@@@@@@@@@@@@@
@       @   @ @                 @     @         @       @     @     @       @   @         @
@ @@@ @ @ @ @ @ @@@ @@@@@@@@@@@ @ @@@ @ @@@@@@@ @ @@@@@ @ @ @ @ @@@ @ @@@@@ @ @ @ @@@@@ @ @
@   @ @   @   @ @ @ @         @ @ @ @ @ @     @ @   @ @ @ @ @ @ @     @   @   @ @   @   @ @
@@@@@ @@@@@@@@@ @ @ @@@@@ @ @@@ @ @ @ @ @ @@@@@ @@@ @ @ @ @ @ @ @@@@@@@@@ @@@ @@@@@ @ @@@@@
@     @     @   @ @     @ @     @ @   @   @       @ @ @   @ @ @   @     @ @   @     @     @
@ @ @@@ @@@ @ @@@ @@@@@ @ @@@@@@@ @ @@@@@@@ @ @@@@@ @ @@@@@ @ @@@ @ @@@ @ @ @@@ @@@@@@@ @ @
@ @ @   @ @           @ @   @     @ @       @ @     @ @     @   @   @   @   @ @ @ @   @ @ @
@ @@@ @@@ @@@@@@@ @@@@@ @@@ @@@ @@@ @ @ @@@@@@@ @@@@@ @ @@@@@@@ @ @@@ @@@@@ @ @ @ @ @ @@@ @
@   @ @   @   @   @   @   @   @ @ @ @ @ @             @ @ @     @   @     @   @   @ @   @ @
@ @ @ @ @ @ @ @@@@@ @ @@@ @@@ @ @ @ @ @@@ @@@@@@@@@@@ @ @ @ @@@@@@@ @@@@@ @@@@@@@ @ @@@ @ @
@ @ @   @ @ @     @ @   @ @     @ @ @     @     @     @ @ @ @     @   @   @       @   @   @
@ @ @ @@@@@ @@@@@ @ @@@ @ @@@@@@@ @ @ @@@@@ @@@ @@@ @@@ @ @ @ @ @@@@@ @ @@@ @@@@@@@@@ @@@ @
@ @   @     @   @ @   @   @   @     @   @ @ @     @ @ @ @   @ @     @ @           @   @   @
@@@@@@@ @@@@@ @@@ @@@ @@@@@ @ @@@ @@@@@ @ @ @@@@@ @ @ @ @@@ @@@@@ @@@ @@@@@@@@@@@ @ @@@ @@@
@       @       @   @       @   @ @   @   @     @ @   @   @     @         @   @!  @ @ @ @ @
@@@@@@@@@ @@@@@ @@@ @ @@@@@@@@@ @ @ @ @@@ @@@@@ @ @@@@@@@ @@@@@ @@@@@@@@@@@ @ @@@@@ @ @ @ @
@       @ @   @ @   @       @   @ @ @       @   @   @     @   @ @         @ @       @ @   @
@ @@@ @ @ @ @ @ @ @@@@@@@@@@@ @@@ @ @@@@@@@@@ @@@@@ @ @@@@@ @ @ @ @@@@@@@ @ @@@@@@@@@ @@@ @
@ @ @ @ @   @ @   @     @   @   @ @ @   @     @       @     @ @ @     @ @   @           @ @
@ @ @ @@@@@@@ @@@@@ @@@ @ @ @@@ @ @@@ @ @ @@@@@@@@@@@@@ @@@@@@@ @@@@@ @ @@@@@ @@@@@@@@@ @ @
@   @       @     @   @ @ @     @   @ @   @   @       @       @     @ @     @     @   @ @ @
@@@ @@@@@ @ @@@@@ @@@ @ @ @@@@@@@@@ @ @@@@@ @ @ @@@@@ @ @@@@@ @@@@@ @ @ @@@ @ @@@ @ @ @ @ @
@ @ @     @ @   @     @   @ @       @ @     @       @ @ @   @     @   @ @ @   @   @ @   @ @
@ @ @ @@@ @@@ @ @@@@@@@@@@@ @ @@@@@@@ @ @@@@@@@@@@@ @ @ @ @ @@@@@ @@@@@ @ @@@@@ @@@@@@@@@ @
@   @ @   @   @ @     @   @   @   @     @     @     @ @   @   @   @     @   @   @       @ @
@ @@@ @@@@@ @@@ @ @@@ @ @ @ @@@ @ @@@@@@@ @@@ @@@@@@@ @@@@@ @@@ @ @ @@@@@ @ @ @ @ @@@@@ @ @
@   @   @   @ @ @ @ @   @   @   @     @   @   @       @   @ @   @ @ @   @ @ @ @ @ @   @ @ @
@@@ @@@ @ @@@ @ @ @ @@@@@@@@@ @@@@@@@ @ @@@ @@@ @@@@@@@ @@@ @ @@@@@ @ @ @ @ @ @@@ @@@ @ @ @
@     @       @               @         @       @           @         @   @ @         @   @
@@@@@@@@@@@@@@@@@@@@@@@@@@@@@@@@@@@@@@@@@@@@@O@@@@@@@@@@@@@@@@@@@@@@@@@@@@@@@@@@@@@@@@@@@@@
