@@@@@@@@@@@@@@@@@@@@@@@@@@@@@@@
@     @           @     @     @
@ @ @@@ @@@@@ @@@ @ @ @ @ @@@ @
@ @       @   @!@ @ @ @   @ @ @
@ @@@@@@@@@ @@@ @ @ @ @@@@@ @ @
@ @ @   @   @ @   @ @ @       @
@ @ @ @ @ @@@ @ @@@ @ @@@ @@@@@
@   @ @ @ @ @   @   @   @     @
@ @@@ @ @ @ @ @@@@@@@@@ @@@@@ @
@ @   @ @ @ @   @   @   @     @
@ @ @@@ @ @ @@@ @ @ @ @@@ @@@@@
@ @ @     @   @   @   @   @   @
@ @ @@@@@@@ @ @ @@@@@@@ @@@ @@@
@ @     @   @   @     @ @   @ @
@ @@@@@ @ @@@@@@@ @@@ @ @ @@@ @
@ @     @   @     @ @ @ @   @ @
@ @ @@@@@@@ @ @@@@@ @ @@@@@ @ @
@ @ @     @ @     @ @   @   @ @
@ @ @ @@@ @@@@@@@ @ @@@ @ @@@ @
@ @     @             @       @
@@@@@@@@@@@@@@@O@@@@@@@@@@@@@@@
